    {
    "MapId": 1,
    "Width": 10,
    "Height": 14,
    "Cells": [
        [ 131,   10,  10,  10,  10,  10,  10,  10,  10,  64],
        [   10,  10,  10,  10,  10,  10,  10,  10,  10,  10],
        [   10,  10,  10,  10,  10,  10,  10,  10,  10,  10],
        [   10,  10,  10,  10, 193, 193,  10,  10,  10,  10],
        [   10,  10,  10, 193, 193, 193, 193,  10,  10,  10],
        [   10,  10, 193, 193, 193, 193, 193, 193,  10,  10],
        [   10,  10, 193, 193, 193, 193, 193, 193,  10,  10],
        [   10,  10, 193, 193, 193, 193, 193, 193,  10,  10],
        [   10,  10, 193, 193, 193, 193, 193, 193,  10,  10],
        [   10,  10,  10, 193, 193, 193, 193,  10,  10,  10],
        [   10,  10,  10,  10, 193, 193,  10,  10,  10,  10],
        [   10,  10,  10,  10,  10,  10,  10,  10,  10,  10],
        [   10,  10,  10,  10,  10,  10,  10,  10,  10,  10],
    ]
}
